PlanetSide 2	Gold
SMITE	Silver
DayZ	Gold
Paladins	Silver
Cyberpunk 2077	Gold
Warframe	Gold
Call of Duty: Black Ops	Silver
Horizon Zero Dawn Complete Edition	Gold
The Riftbreaker	Gold
Black Squad	Silver
Warhammer 40,000: Space Marine - Anniversary Edition	Gold
Path of Exile	Gold
Tom Clancy's Rainbow Six Siege	Bronze
Call of Duty: Black Ops III	Gold
Fallout 4	Gold
DEATH STRANDING	Gold
Duke Nukem Forever	Silver
Hell Let Loose	Bronze
Elite Dangerous	Gold
F1 2021	Silver
The Darkness II	Silver
Divinity: Original Sin 2 - Definitive Edition	Gold
Bloons TD 6	Platinum
Monster Hunter: World	Gold
GRID 2	Bronze
Insurgency: Sandstorm	Bronze
Aliens vs. Predator	Silver
Red Dead Redemption 2	Gold
Homefront	Bronze
Kane & Lynch 2: Dog Days	Bronze
Halo: The Master Chief Collection	Gold
Far Cry 5	Gold
The Elder Scrolls V: Skyrim Special Edition	Gold
Grand Theft Auto IV: The Complete Edition	Gold
CastleStorm	Silver
Age of Empires: Definitive Edition	Platinum
FINAL FANTASY XIV Online	Gold
The Great Ace Attorney Chronicles	Silver
Saints Row: The Third	native
Sid Meier’s Civilization VI	native
DARK SOULS: REMASTERED	Platinum
Dishonored	Platinum
Bayonetta	Gold
The Typing of The Dead: Overkill	Bronze
HighFleet	Gold
The Bureau: XCOM Declassified	Silver
VRChat	Gold
STAR OCEAN - THE LAST HOPE - 4K & Full HD Remaster	Bronze
Persona 4 Golden	Gold
BioShock Infinite	native
Red Dead Online	Gold
The Forest	Gold
Fallout 3: Game of the Year Edition	Gold
Levelhead	Silver
Marvel's Avengers	Bronze
Just Cause 3	Gold
World of Tanks Blitz	Gold
Nioh: Complete Edition / 仁王 Complete Edition	Silver
Just Cause 2	Silver
Lara Croft and the Guardian of Light	Bronze
GreedFall	Silver
DiRT Rally 2.0	Gold
Borderlands 3	Gold
Gothic 1	Gold
Resident Evil Village	Gold
Battlefield 4	Platinum
Forza Horizon 4	Silver
Viking: Battle for Asgard	Bronze
GRIS	Gold
Arma 3	Gold
Lord of the Rings: War in the North	Bronze
Dishonored 2	Gold
F1 RACE STARS	Bronze
RaceRoom Racing Experience	Bronze
War Thunder	native
Homeworld Remastered Collection	Gold
Battlefield V	Gold
Little Nightmares	Platinum
Ghostrunner	Platinum
Sleeping Dogs	Bronze
Anno 2070	Silver
Plants vs. Zombies GOTY Edition	Platinum
Mount & Blade II: Bannerlord	Gold
Pinball FX3	Silver
Timelie	Platinum
Microsoft Flight Simulator	Gold
Batman: Arkham Asylum Game of the Year Edition	Gold
The Witcher 3: Wild Hunt	Platinum
Rocksmith 2014 Edition - Remastered	Gold
theHunter: Call of the Wild	Gold
Pathologic Classic HD	Bronze
DOOM Eternal	Gold
Frostpunk	Gold
Splitgate: Arena Warfare	Silver
Kingdom Come: Deliverance	Gold
Bully: Scholarship Edition	Gold
Call of Duty: Modern Warfare 3	Silver
Bulletstorm: Full Clip Edition	Bronze
Mafia: Definitive Edition	Gold
Mass Effect Legendary Edition	Gold
Titanfall 2	Gold
Resident Evil 4	Platinum
Detroit: Become Human	Platinum
Disco Elysium - The Final Cut	Gold
Rocket League	native
LEGO The Lord of the Rings	Gold
Mafia II: Definitive Edition	Gold
Grand Theft Auto V	Gold
The Witness	Gold
Grim Dawn	Platinum
Sekiro: Shadows Die Twice - GOTY Edition	Platinum
Tom Clancy’s Splinter Cell Blacklist	Silver
Portal 2	native
STAR WARS Jedi Knight - Jedi Academy	Gold
Sid Meier’s Ace Patrol	Bronze
Over 9000 Zombies!	Bronze
State of Decay 2: Juggernaut Edition	Gold
Shtriga: Summer Camp	Bronze
Realm Royale	Bronze
STAR WARS Battlefront II	Platinum
Call of Duty: Black Ops II	Bronze
Steep	Silver
DOOM	Platinum
Sonic Adventure 2	Gold
Assetto Corsa	Silver
Squad	Gold
Victoria II	Gold
F.E.A.R. 3	Bronze
Left 4 Dead	Gold
METAL GEAR SOLID V: GROUND ZEROES	Platinum
Planet Zoo	Platinum
WRC 8 FIA World Rally Championship	Silver
Deep Rock Galactic	Platinum
PC Building Simulator	Gold
Warhammer: End Times - Vermintide	Gold
Baldur's Gate 3	Gold
Mirror's Edge Catalyst	Platinum
Crysis Warhead	Gold
House Party	Silver
Evil Genius 2: World Domination	Gold
Catherine Classic	Bronze
Shin Megami Tensei III Nocturne HD Remaster	Gold
House Flipper	Platinum
Fallout: New Vegas	Gold
METAL GEAR SOLID V: THE PHANTOM PAIN	Platinum
STAR WARS: Squadrons	Silver
The Elder Scrolls Online	Gold
Sniper Elite 4	Gold
Call of Duty: Modern Warfare 2	Silver
BIT.TRIP RUNNER	Gold
F1 2012	Bronze
Sang-Froid - Tales of Werewolves	Bronze
Rez Infinite	Silver
Batman: Arkham Knight	Platinum
DARK SOULS II: Scholar of the First Sin	Platinum
Days Gone	Platinum
Far Cry 4	Gold
Far Cry 2: Fortune's Edition	Gold
Castle of Illusion	Platinum
Deus Ex: Mankind Divided	native
Fallout Shelter	Gold
Borderlands 2	native
Super Animal Royale	Platinum
DIRT 5	Gold
TrackMania Nations Forever	Platinum
Jet Set Radio	Gold
EARTH DEFENSE FORCE 4.1 The Shadow of New Despair	Gold
Aliens: Colonial Marines Collection	Silver
Total War: WARHAMMER II	native
Mafia II (Classic)	Silver
Spec Ops: The Line	native
Sonic Generations Collection	Gold
Way of the Samurai 4	Bronze
Library Of Ruina	Gold
Age of Wonders: Planetfall	Gold
Call of Cthulhu	Gold
Resident Evil 7 Biohazard	Gold
Stormworks: Build and Rescue	Platinum
Stick Fight: The Game	Gold
Street Fighter V	Gold
Resident Evil 2	Gold
R.A.W. Realms of Ancient War	Bronze
AdVenture Capitalist	native
Zup! F	Silver
Tales of the Neon Sea	Bronze
Jurassic World Evolution	Platinum
Assassin's Creed III Remastered	Gold
ARK: Survival Evolved	native
Ori and the Blind Forest: Definitive Edition	Platinum
BIGFOOT	Silver
Valkyria Chronicles	Gold
F1 2020	Platinum
TROUBLESHOOTER: Abandoned Children	Silver
EZ2ON REBOOT : R	Silver
Geometry Dash	Gold
Kenshi	Gold
Magicka	Silver
Rise of the Triad	Silver
Age of Mythology: Extended Edition	Gold
Mafia III	Silver
TEKKEN 7	Platinum
Prey	Platinum
Sea of Thieves	Gold
Fallout 3	Gold
Company of Heroes 2	native
Potion Craft: Alchemist Simulator	Platinum
Gothic II: Gold Edition	Silver
WORLD OF FINAL FANTASY	Silver
Batman: Arkham Origins	Gold
Deus Ex: Human Revolution - Director's Cut	Gold
UBOAT	Gold
Gloomhaven	Gold
Eternal Return	Silver
Fallout 76	Gold
Little Busters! English Edition	Bronze
Wings of Vi	Silver
ABZU	Gold
F1 2016	Silver
DEAD RISING	Silver
Yakuza 0	Platinum
Bloons TD 5	Platinum
Tom Clancy's Ghost Recon Wildlands	Gold
Planet Coaster	Gold
SOULCALIBUR VI	Gold
Neon Abyss	Gold
A Hat in Time	Gold
Noita	Gold
The Haunted: Hells Reach	Silver
Fable - The Lost Chapters	Silver
Injustice: Gods Among Us Ultimate Edition	Gold
Viscera Cleanup Detail	Platinum
Hob	Gold
Atelier Ryza 2: Lost Legends & the Secret Fairy	Silver
Titan Quest Anniversary Edition	Platinum
S.T.A.L.K.E.R.: Shadow of Chernobyl	Platinum
Subnautica: Below Zero	Platinum
Wingspan	Platinum
PowerWash Simulator	Platinum
Chernobylite	Gold
BioShock	Gold
Fallout: A Post Nuclear Role Playing Game	Platinum
Strange Brigade	Gold
Far Cry New Dawn	Gold
METAL GEAR RISING: REVENGEANCE	Gold
People Playground	Gold
Risk of Rain 2	Platinum
Sonic Mania	Platinum
1... 2... 3... KICK IT! (Drop That Beat Like an Ugly Baby)	Bronze
Sniper Elite V2	Bronze
Penny Arcade's On the Rain-Slick Precipice of Darkness 3	Borked
Fly'N	Silver
Storm	Bronze
Banished	Platinum
Invisible, Inc.	native
Sid Meier’s Ace Patrol: Pacific Skies	Borked
Flashback	Borked
Skyscraper Simulator	Bronze
Bloody Trapland	Borked
Agarest: Generations of War Zero	Bronze
Gunhound EX	Bronze
Fairy Tale About Father Frost, Ivan and Nastya	Bronze
TransOcean: The Shipping Company	Gold
The Sun at Night	Bronze
Phoenix Force	Bronze
Weird Park Trilogy	Bronze
All Is Dust	Bronze
Staxel	Borked
The Hurricane of the Varstray -Collateral hazard-	Borked
Uncrewed	Bronze
Make America Great Again: The Trump Presidency	Bronze
Carrie's Order Up!	Bronze
Badiya: Desert Survival	Bronze
Empire of Sin	Gold
Super Fancy Pants Adventure	Silver
Call of Duty: World at War	Platinum
Grand Theft Auto: San Andreas	Gold
Crysis 2 - Maximum Edition	Gold
Age of Empires II: Definitive Edition	Gold
Devil May Cry HD Collection	Bronze
QUAKE II	Gold
The Witcher 2: Assassins of Kings Enhanced Edition	native
Death's Gambit: Afterlife	Gold
FINAL FANTASY IX	Gold
Air Conflicts: Secret Wars	Bronze
Divekick	Silver
Assassin's Creed Unity	Gold
LEGO Marvel Super Heroes 2	Silver
Subnautica	Platinum
Hollow Knight	native
Far Cry 3 - Blood Dragon	Gold
Sniper Elite 3	Gold
Bloons TD Battles	Platinum
Snake Pass	Gold
Darksiders III	Platinum
Yu-Gi-Oh! Duel Links	Gold
OMORI	Gold
DeathSpank	Bronze
Darksiders	Bronze
inMomentum	Bronze
Resident Evil: Operation Raccoon City	Bronze
1953 - KGB Unleashed	Bronze
AudioSurf	Gold
Pinball Arcade	Silver
Master Reboot	Gold
Quantum Break	Gold
A Way Out	Silver
Stellaris	native
Supreme Commander: Forged Alliance	Gold
Katana ZERO	Platinum
BlazBlue: Cross Tag Battle	Gold
A Dance of Fire and Ice	Gold
GWENT: The Witcher Card Game	Platinum
Hearts of Iron III	Bronze
The Eden of Grisaia	Silver
BlazBlue Centralfiction	Gold
Accel World VS. Sword Art Online Deluxe Edition	Bronze
Age of Empires III (2007)	Gold
Edge Of Eternity	Gold
FINAL FANTASY XIII	Gold
I Am Bread	Silver
The Legend of Dark Witch	Gold
Symphonic Rain	Gold
Cyberdimension Neptunia: 4 Goddesses Online	Silver
Command & Conquer 4: Tiberian Twilight	Bronze
Raiden V: Director's Cut | 雷電 V Director's Cut | 雷電V:導演剪輯版	Silver
Endless World Idle RPG	Bronze
Ticket to Ride	Gold
ENSLAVED: Odyssey to the West Premium Edition	Gold
Delve Deeper	Silver
Blacklight: Retribution	Bronze
MANOS	Bronze
Z1 Battle Royale	Bronze
Not For Broadcast: Prologue	Bronze
Tales of Berseria	Gold
QUAKE II Mission Pack: Ground Zero	Bronze
Unreal 2: The Awakening	Bronze
STAR WARS - Knights of the Old Republic	Gold
ArcaniA	Bronze
Risen 2: Dark Waters	Bronze
Worms Armageddon	Gold
The Banner Saga 2	Gold
Devil May Cry 4 Special Edition	Gold
Voidspire Tactics	Silver
Syberia 3	Gold
Mugen Souls Z	Bronze
The Evil Within 2	Gold
Pandemic: The Board Game	Gold
The Drone Racing League Simulator	Bronze
Generation Zero	Gold
OshiRabu: Waifus Over Husbandos	Bronze
Unreal Tournament 3 Black	Gold
Town of Salem	Gold
Spyro Reignited Trilogy	Platinum
QUAKE II Mission Pack: The Reckoning	Bronze
Nexuiz	Bronze
XCOM: Enemy Unknown	native
Men of War: Assault Squad 2	Bronze
Summoner	Bronze
Interstellar Rift	Bronze
New World	Borked
Dark Messiah of Might & Magic	Gold
Ghost Master	Bronze
Grand Theft Auto: Vice City	Gold
Luxor 2	Silver
DeathSpank: Thongs of Virtue	Bronze
Fallout: New Vegas	Gold
Train Simulator 2022	Gold
Fallout 2: A Post Nuclear Role Playing Game	Gold
Red Faction: Armageddon	Platinum
ArcaniA: Fall of Setarrif	Bronze
Orcs Must Die! 2	Gold
Hitman: Absolution	Silver
How to Survive	Gold
Toybox Turbos	Gold
Advanced Tactics Gold	Bronze
DiRT Rally	native
Agarest: Generations of War 2	Silver
Planetbase	Gold
Spelunky 2	Gold
Surviving Mars	native
Nights of Azure	Bronze
Haydee	Silver
Element TD	Silver
Hunt Down The Freeman	Bronze
Between the Stars	Bronze
DYNASTY WARRIORS 9	Gold
112 Operator	Silver
Bloons Adventure Time TD	Gold
Yakuza 4 Remastered	Gold
Suzerain	Platinum
She Will Punish Them	Silver
Sherlock Holmes - Nemesis	Silver
Prototype 2	Bronze
Oozi: Earth Adventure	Silver
Mega Man Legacy Collection 2	Silver
HELLION	Bronze
Superfighters Deluxe	Bronze
Sleeping Dogs: Definitive Edition	Gold
FINAL FANTASY XV WINDOWS EDITION	Gold
Rocket Knight	Silver
Dungeon Defenders II	Gold
Edna & Harvey: The Breakout	Bronze
Sonic Lost World	Gold
Dirty Bomb	Borked
AKIBA'S TRIP: Undead ＆ Undressed	Silver
DUSK	Gold
Changed	Gold
Power Rangers: Battle for the Grid	Gold
Subverse	Gold
Tropico 4	Gold
LEGO Batman 2: DC Super Heroes	Silver
Duck Game	Gold
Dr. Langeskov, The Tiger, and The Terribly Cursed Emerald: A Whirlwind Heist	Gold
Yakuza Kiwami 2	Platinum
Spin Rhythm XD	Gold
The Longest Journey	Silver
Joint Operations: Combined Arms Gold	Bronze
Lords Of The Fallen	Silver
Haunt the House: Terrortown	Silver
Eidolon	Silver
Sins Of The Demon RPG	Silver
ZONE OF THE ENDERS THE 2nd RUNNER : M∀RS / アヌビス ゾーン・オブ・エンダーズ : マーズ	Silver
Ancient Cities	Gold
The Sojourn	Silver
NASCAR Heat 3	Silver
Onirism	Silver
Disgaea 4 Complete+	Silver
Mists of Aiden	Silver
Cobra Kai: The Karate Kid Saga Continues	Silver
Devolverland Expo	Bronze
My Singing Monsters	Silver
SpellForce 3	Gold
SYNTHETIK: Legion Rising	Gold
F1 2011	Bronze
SNOW	Silver
rFactor	Bronze
King of Dragon Pass	Silver
War of Rights	Silver
Line of Sight	Silver
Street Legal Racing: Redline v2.3.1	Silver
Intruder	Bronze
Shoppe Keep 2 - Online co-op open world first person resource management RPG	Bronze
Sid Meier's Civilization V	native
Realm of the Mad God Exalt	Gold
Borderlands: The Pre-Sequel	native
Homeworld: Deserts of Kharak	Platinum
MONMUSU	Platinum
Ultimate Epic Battle Simulator	Gold
Unravel Two	Gold
TOXIKK	Gold
Ancient Planet Tower Defense	Silver
The Juicer	Silver
Call of Duty: WWII	Silver
SeaBed	Silver
Home Sweet Home	Silver
Beat Saber	Platinum
Desert Bus VR	Silver
Destroy All Humans!	Platinum
DRAGON QUEST BUILDERS 2	Silver
DARK SOULS III	Gold
Medieval Dynasty	Gold
The Sims 4	Gold
Cry of Fear	Silver
The Room Three	Gold
Agony UNRATED	Gold
Trials of Mana	Gold
StarDrive	Silver
Q.U.B.E: Director's Cut	native
Enemy Mind	Silver
Lemma	Bronze
If My Heart Had Wings	Silver
SimpleRockets	Silver
Tales of Symphonia	Silver
PixARK	Silver
Disneyland Adventures	Gold
Youropa	Silver
AdventureQuest 3D	Platinum
Mirror	Gold
Mutant Year Zero: Road to Eden	Gold
The Henry Stickmin Collection	Gold
EVERSPACE 2	Gold
Bloons Monkey City	Gold
Sonic Adventure DX	Platinum
Wolfenstein II: The New Colossus	Platinum
Rock of Ages	Gold
Stronghold 2: Steam Edition	Silver
Game of Thrones	Silver
El Matador	Silver
Sherlock Holmes: The Devil's Daughter	Gold
Evoland 2	Silver
Tree of Savior (English Ver.)	Silver
Nex Machina	Silver
Battle Realms: Zen Edition	Silver
Dyson Sphere Program	Platinum
Warhammer 40,000: Dawn of War - Game of the Year Edition	Platinum
Borderlands Game of the Year	Gold
ORION: Prelude	Silver
Project Zomboid	native
Rocksmith	Silver
Dishonored	Gold
Woolfe - The Red Hood Diaries	Silver
ENDLESS Legend	Platinum
LARA CROFT AND THE TEMPLE OF OSIRIS	Gold
Rain World	Gold
Battlefleet Gothic: Armada	Gold
Anno 2205	Silver
Vampyr	Platinum
Yomawari: Night Alone / 夜廻	Silver
Life is Strange: Before the Storm	native
Killer Instinct	Silver
Sword Art Online: Fatal Bullet	Gold
MUSYNX	Silver
Eldest Souls	Gold
Blue Fire	Gold
Football Manager 2021	Gold
Prince of Persia: The Sands of Time	Gold
Ryse: Son of Rome	Platinum
LEGO Worlds	Platinum
Okami HD	Platinum
Steel Division 2	Silver
Record of Lodoss War-Deedlit in Wonder Labyrinth-	Platinum
ROUNDS	Platinum
Bionic Commando: Rearmed	Silver
America's Army: Proving Grounds	Gold
Hell Yeah! Wrath of the Dead Rabbit	Silver
STRIDER / ストライダー飛竜	Silver
CONSORTIUM	Gold
Sid Meier's Starships	Silver
Grey Goo	Gold
Call of Duty: Infinite Warfare	Gold
FINAL FANTASY X/X-2 HD Remaster	Gold
Onmyoji	Silver
Borderlands Game of the Year Enhanced	Gold
A Plague Tale: Innocence	Platinum
HITMAN 2	Platinum
Tower Unite	Platinum
Battlefield: Bad Company 2	Platinum
Insurgency	native
Wasteland 2: Director's Cut	native
Heat Signature	Gold
Disney Planes	Silver
Niko: Through The Dream	Silver
AXYOS	Gold
Greyfox RPG	Silver
Hatred	native
Tales of Zestiria	Gold
how do you Do It?	Silver
Spooky Cats	Silver
Scrap Mechanic	Gold
Legend of Mysteria RPG	Silver
Shooting Stars!	native
Samorost 3	Gold
Conception II: Children of the Seven Stars	Silver
Event[0]	Silver
Elven Assassin	Silver
Geo	Silver
Dropzone	Silver
Visage	Gold
MetaMorph: Dungeon Creatures	Gold
Eiyu*Senki – The World Conquest	Silver
Project Rhombus	Silver
Assetto Corsa Competizione	Gold
Green Hell	Platinum
Sword Art Online: Lost Song	Silver
Comanche	Silver
Train Station Renovation	Silver
Anno 1800	Gold
Balsa Model Flight Simulator	Silver
Shards of Infinity	Silver
Little Witch Nobeta	Gold
Jump King	Gold
INDUSTRIA	Gold
Kingdoms Reborn	Silver
Rubber Bandits: Christmas Prologue	Silver
Doctor Who: The Lonely Assassins	Bronze
Grand Theft Auto III	Gold
Alan Wake	Platinum
Space Channel 5: Part 2	Gold
The Legend of Heroes: Trails in the Sky SC	Silver
Rodina	Silver
Resident Evil 0	Gold
Phantom Doctrine	Gold
SAS: Zombie Assault 4	Silver
The Song of Saya	Silver
DEAD OR ALIVE 6	Silver
Unravel	Silver
Mass Effect 3 N7 Digital Deluxe Edition (2012)	Silver
MechWarrior Online Solaris 7	Gold
NieR Replicant ver.1.22474487139...	Gold
DOOM II	Gold
LEGO Star Wars - The Complete Saga	Gold
THE KING OF FIGHTERS 2002 UNLIMITED MATCH	Gold
Shadow Tactics: Blades of the Shogun	native
Phoenix Wright: Ace Attorney Trilogy	Gold
Outward	Gold
BONEWORKS	Platinum
STEINS;GATE 0	Gold
Project Warlock	Gold
NGU IDLE	Gold
Carto	Platinum
Assassin’s Creed IV Black Flag	Gold
They Are Billions	Silver
Breathedge	Gold
Crysis 3	Silver
BioShock 2	Silver
Resident Evil 5	Gold
Cargo! The Quest for Gravity	Gold
Chivalry: Medieval Warfare	native
Angry Video Game Nerd Adventures	Silver
Resident Evil Revelations 2	Silver
Secret Of Magia	Gold
Tank Warfare: Tunisia 1943	Silver
Tokyo Xanadu eX+	Gold
Blasphemous	Gold
killer7	Gold
Felix The Reaper	Gold
9-nine-:Episode 1	Gold
Haven	Gold
Gensokyo Night Festival	Silver
Yakuza: Like a Dragon	Gold
STAR WARS Empire at War - Gold Pack	Gold
Metro 2033 Redux	native
Temtem	Gold
Shattered Union	Gold
Supreme Commander	Gold
Sid Meier's Civilization IV: Colonization	Silver
SEGA Mega Drive and Genesis Classics	native
Might & Magic: Heroes VI	Gold
Portal 2 - The Final Hours	Bronze
LOST PLANET 3	Silver
NARUTO SHIPPUDEN: Ultimate Ninja STORM 3 Full Burst HD	Silver
Takedown: Red Sabre	Silver
Super Puzzle Platformer Deluxe	Silver
realMyst: Masterpiece Edition	Gold
DYNASTY WARRIORS 8: Xtreme Legends Complete Edition	Silver
The Guild 3	Gold
Shenmue I & II	Gold
Project Winter	Gold
The Void Rains Upon Her Heart	Platinum
Coloring Game: Little City	Silver
F.E.A.R. 2: Project Origin	Gold
Tom Clancy's Rainbow Six 3 Gold	Gold
The Sims 3	Gold
Out There Somewhere	Silver
Rise of Nations: Extended Edition	Gold
One Piece Pirate Warriors 3	Silver
Dead Island: Riptide Definitive Edition	native
Project Arrhythmia	Platinum
Gold Rush: The Game	Silver
Storm Of Spears RPG	Silver
Super Cloudbuilt	Gold
Empires Apart	Silver
64.0	Silver
WRC 7 FIA World Rally Championship	Gold
V-Rally 4	Gold
Fight'N Rage	Gold
The Legend of Heroes: Trails of Cold Steel II	Gold
Chrono Ark	Gold
Fe	Silver
NASCAR Heat 5	Gold
Half-Life	native
Luxor 3	Platinum
LEGO Batman: The Videogame	Platinum
LEGO Harry Potter: Years 1-4	Platinum
Street Fighter X Tekken	Gold
TrackMania² Stadium	Gold
Thief	Gold
Primal Carnage: Extinction	Bronze
Disney•Pixar Cars	Platinum
Halo Wars: Definitive Edition	Platinum
Carcassonne - Tiles & Tactics	Gold
Devil May Cry 5	Gold
Clicker Heroes 2	Bronze
Donut County	Platinum
Severed Steel	Platinum
SUCCUBUS	Gold
Cruelty Squad	Gold
FlatOut 2	Platinum
Max Payne	Platinum
Unreal Tournament: Game of the Year Edition	Platinum
Tribes: Ascend	Gold
Dead Space	Platinum
Red Orchestra 2: Heroes of Stalingrad with Rising Storm	Gold
Spiral Knights	Silver
Waves	Gold
Divinity II: Developer's Cut	Gold
Incredipede	Silver
Middle-earth: Shadow of Mordor	native
Styx: Master of Shadows	Platinum
Deus Ex: The Fall	Gold
Dragon Nest Europe	Gold
Carnivores: Dinosaur Hunter Reborn	Silver
Acceleration of SUGURI 2	Platinum
Wuppo: Definitive Edition	Gold
Shaolin vs Wutang	Gold
A Fisherman's Tale	Gold
Alien Swarm: Reactive Drop	Platinum
Golf It!	Platinum
Street Fighter 30th Anniversary Collection	Platinum
CHRONO TRIGGER	Silver
My Time At Portia	Platinum
Dead Frontier 2	Gold
Skater XL - The Ultimate Skateboarding Game	Gold
Twelve Minutes	Platinum
Pumpkin Jack	Gold
Rogue Legacy 2	Platinum
Midnight Castle Succubus DX	Gold
Bejeweled 2 Deluxe	Gold
L.A. Noire	Silver
Shantae and the Pirate's Curse	Gold
Sniper Ghost Warrior 3	Gold
Attack on Titan / A.O.T. Wings of Freedom	Bronze
My Friend Pedro	Platinum
Sword Art Online: Hollow Realization Deluxe Edition	Gold
Batman: The Enemy Within - The Telltale Series	Platinum
Beyond: Two Souls	Gold
Blood: Fresh Supply	Platinum
Mad Games Tycoon 2	Platinum
RollerCoaster Tycoon 3: Platinum	Gold
Iron Brigade	Gold
Age of Wonders III	native
Galactic Civilizations III	Silver
RollerCoaster Tycoon 2: Triple Thrill Pack	Gold
Five Nights at Freddy's 2	Gold
Assassin’s Creed Chronicles: China	Gold
FINAL FANTASY VI (Old ver.)	Gold
Destiny Warriors RPG	Platinum
BERSERK and the Band of the Hawk	Silver
Gal*Gun: Double Peace	Gold
Parkasaurus	Gold
Clone Drone in the Danger Zone	Gold
Car Mechanic Simulator 2018	Gold
Fox Hime	Gold
eFootball PES 2020	Gold
Anno 1404 - History Edition	Gold
Mini Motorways	Platinum
Mount Your Friends	Bronze
Call of Duty 2	Gold
Cossacks: European Wars	Gold
Elven Legacy	Gold
Super Meat Boy	native
Binary Domain	Gold
Cortex Command	Gold
Alien Rage - Unlimited	Gold
Don't Starve	native
Brothers - A Tale of Two Sons	Platinum
Prison Architect	native
Knights and Merchants	native
Valiant Hearts: The Great War / Soldats Inconnus : Mémoires de la Grande Guerre	Silver
Hero Siege	native
IL-2 Sturmovik: Battle of Stalingrad	Gold
Pool Nation FX Lite	Gold
UNLOVED	Gold
Reflex Arena	Gold
Hektor	Platinum
RIDE	Gold
Dreamscapes: Nightmare's Heir - Premium Edition	Gold
ULTIMATE MARVEL VS. CAPCOM 3	Gold
Dragon Saga	Gold
SimplePlanes	Gold
Rabi-Ribi	Gold
Dawn of Andromeda	Platinum
World's Dawn	Platinum
Party Jousting	Silver
DRAGON BALL XENOVERSE 2	Gold
Floppy Heroes	Platinum
Rogue Trooper Redux	Gold
Pharaoh + Cleopatra	Gold
Ignition	Gold
Cyberhunt	Gold
Zup! 7	Gold
Do Not Feed the Monkeys	Gold
Wasteland 3	Gold
Max Gentlemen Sexy Business!	Gold
GUILTY GEAR	Gold
SENRAN KAGURA Burst Re:Newal	Gold
TAPSONIC BOLD	Gold
Lust from Beyond	Silver
Hundred Days - Winemaking Simulator	Gold
Granny Simulator	Gold
Before Your Eyes	Gold
Summer Memories	Gold
DOOM 3	Platinum
Total War: NAPOLEON – Definitive Edition	Gold
ACE COMBAT 7: SKIES UNKNOWN	Platinum
Neon Beats	Gold
Orcs Must Die! 3	Gold
RACE 07	Gold
Rise of the Argonauts	Gold
Mass Effect (2007)	Gold
S.T.A.L.K.E.R.: Clear Sky	Gold
EverQuest II	Gold
Thief Gold	Gold
NiGHTS Into Dreams	Gold
Vector	Gold
Ludwig	Gold
Mortal Kombat X	Gold
Super Panda Adventures	Gold
The Flame in the Flood	Platinum
Still Not Dead	Gold
Total War: WARHAMMER	native
Little Big Adventure 2	Gold
LEGO MARVEL's Avengers	Gold
Wolcen: Lords of Mayhem	Gold
Shadwen	native
Grow Up	Platinum
The Lord of the Rings: Adventure Card Game - Definitive Edition	Platinum
Star Trek: Bridge Crew	Gold
VOI	Gold
Witch It	Gold
Zup! Zero	Gold
Stoneshard	Gold
Flipping Death	Gold
Soldat	Gold
LEGO The Incredibles	Silver
EARTH DEFENSE FORCE 5	Platinum
Gamecraft	Gold
[NINJA GAIDEN: Master Collection] NINJA GAIDEN Σ	Gold
DARK SOULS: Prepare To Die Edition	Gold
The Legend of Heroes: Trails of Cold Steel	Gold
Not For Broadcast	Silver
Aliens versus Predator Classic 2000	Gold
PAC-MAN Championship Edition DX+	Platinum
Dungeon of the ENDLESS	Platinum
RimWorld	native
GemCraft - Chasing Shadows	Gold
Human: Fall Flat	Platinum
Lobotomy Corporation | Monster Management Simulation	Platinum
Maneater	Gold
Fox Hime Zero	Gold
Session: Skateboarding Sim Game	Platinum
WRATH: Aeon of Ruin	Platinum
GemCraft - Frostborn Wrath	Platinum
Fallout Tactics: Brotherhood of Steel	Gold
PixelJunk Eden	Gold
The Night of the Rabbit	Gold
KickBeat Steam Edition	Gold
Gauntlet Slayer Edition	Platinum
Super Motherload	Gold
Creativerse	Gold
LEGO Batman 3: Beyond Gotham	Gold
404Sight	Gold
Project Highrise	native
Monster Boy and the Cursed Kingdom	Gold
AdVenture Communist	Gold
Bus Simulator 18	Gold
Runner3	Gold
Warhammer 40,000: Inquisitor - Martyr	Gold
Laser League	Gold
Wild Guns Reloaded	Gold
The LEGO NINJAGO Movie Video Game	Gold
Yet Another Zombie Defense HD	Gold
The Walking Dead: Saints & Sinners	Platinum
Encased: A Sci-Fi Post-Apocalyptic RPG	Gold
Death end re;Quest	Gold
Mirror's Edge	Platinum
Tomb Raider	native
Dragon's Dogma: Dark Arisen	Gold
Ori and the Will of the Wisps	Gold
Delta Force Land Warrior	Gold
Crash Time 3	Gold
Supreme Commander 2	Gold
Still Life	Gold
1000 Amps	Gold
Angry Birds Space	Silver
Europa Universalis IV	native
Intake	Platinum
868-HACK	Gold
Ys VI: The Ark of Napishtim	Platinum
Soul Gambler	Gold
SpaceEngine	Gold
Fortified	Gold
Glorkian Warrior: The Trials Of Glork	Gold
Europe at War	Gold
Kholat	Gold
METAL SLUG DEFENSE	Platinum
Prominence Poker	Platinum
Pretty Girls Mahjong Solitaire	Platinum
ARCADE GAME SERIES: GALAGA	Platinum
Xuan-Yuan Sword: The Gate of Firmament	Gold
Golf With Your Friends	native
The Chosen RPG	Platinum
Overcooked	Gold
Days of War: Definitive Edition	Gold
Apollo 11 VR	Platinum
ChuSingura46+1 S	Platinum
Nine Parchments	Gold
Ball 3D	Gold
The Thrill of the Fight - VR Boxing	Gold
Carmageddon: Max Damage	Silver
Delicious! Pretty Girls Mahjong Solitaire	Gold
√Letter - Root Letter -	Gold
THE KING OF FIGHTERS XIV STEAM EDITION	Gold
We Were Here	Gold
Dishonored: Death of the Outsider	Gold
TT Isle of Man	Gold
Idle Champions of the Forgotten Realms	Gold
Red Faction Guerrilla Re-Mars-tered	Gold
Door Kickers: Action Squad	Gold
Precision Archery: Competitive	Gold
Game Dev Studio	Platinum
Valkyria Chronicles 4 Complete Edition	Gold
SNK HEROINES Tag Team Frenzy	Gold
UNDER NIGHT IN-BIRTH Exe:Late[cl-r]	Gold
SpellForce 3: Soul Harvest	Gold
Zombie Builder Defense	Gold
A Legionary's Life	Gold
Atelier Ryza: Ever Darkness & the Secret Hideout	Gold
Hentai Girl Fantasy	Platinum
Hentai Asmodeus	Platinum
Going Under	Platinum
Kill It With Fire	Gold
Lacuna – A Sci-Fi Noir Adventure	Platinum
Kingdom Rush Vengeance - Tower Defense	Platinum
Mind Scanners	Gold
Tiny Bunny	Gold
鬼谷八荒 Tale of Immortal	Platinum
Battlerite	Gold
Return to Castle Wolfenstein	Platinum
Grand Theft Auto 2	Gold
Tom Clancy's Splinter Cell	Gold
Call of Cthulhu: Dark Corners of the Earth	Gold
Burnout Paradise: The Ultimate Box	Platinum
Mass Effect 2 (2010)	Gold
S.T.A.L.K.E.R.: Call of Pripyat	Gold
Rayman Origins	Gold
Resonance	Gold
POSTAL 2	native
Project CARS	Gold
Small World	Gold
Spintires	Platinum
Hostile Waters: Antaeus Rising	Platinum
Zombie Army Trilogy	Gold
Arizona Sunshine	Gold
Koi-Koi Japan [Hanafuda playing cards]	Platinum
Twilight Struggle	Gold
Wildfire	Gold
Shadowverse CCG	Gold
TumbleSeed	Gold
The Shrouded Isle	Gold
Mages of Mystralia	Gold
FAR: Lone Sails	Platinum
Remnant: From the Ashes	Gold
Sonic Forces	Platinum
Return of the Obra Dinn	Platinum
Shantae: Half-Genie Hero Ultimate Edition	Gold
The Messenger	Platinum
Clue/Cluedo: The Classic Mystery Game	Gold
Terminator: Resistance	Platinum
Prodeus	Gold
Sniper Ghost Warrior Contracts	Platinum
古剑奇谭三(Gujian3)	Gold
Warhammer Underworlds: Online	Platinum
Devolver Bootleg	Platinum
Slapshot: Rebound	Gold
Dead Space 3	Gold
Samorost 2	Platinum
HITMAN	native
20XX	Platinum
Disgaea PC	Gold
Katamari Damacy REROLL	Platinum
SimpleRockets 2	Gold
Panzer Paladin	Bronze
Rivals of Aether	Gold
Tomb Raider: Anniversary	Platinum
Silent Hunter III	Platinum
Sonic & SEGA All-Stars Racing	Gold
Orcs Must Die!	Platinum
Remember Me	Platinum
Don't Starve Together	native
Styx: Shards of Darkness	Platinum
OCTOPATH TRAVELER	Platinum
Mortal Kombat 11	Silver
Automachef	Gold
Metal Unit	Platinum
Arx Fatalis	Platinum
Tales of Monkey Island: Complete Season	Platinum
FINAL FANTASY VII	Gold
Greed Corp	Platinum
Nidhogg	Gold
ENDLESS Space - Definitive Edition	Gold
Lunar Flight	Gold
The Incredible Adventures of Van Helsing	Platinum
The Legend of Heroes: Trails in the Sky	Gold
Stonehearth	Silver
The Talos Principle	native
State of Decay: YOSE	Platinum
The Elder Scrolls: Legends	Platinum
Volume	Gold
CrossCode	native
Eco	native
SENRAN KAGURA SHINOVI VERSUS	Gold
Democracy 3 Africa	Platinum
The Turing Test	Platinum
Crashday Redline Edition	Gold
Them's Fightin' Herds	Platinum
The Vagrant	Gold
The Fidelio Incident	Gold
Tannenberg	native
Mega Man 11	Gold